WWWWWWWWWWWWWWWWW
WFFFWWTCFFWWFFFFW
WFFFFFFFFFFFFFFFW
WWWWWFFWWTTTWWWWW
WWFFTTTFFFFWWFCFW
WFFWWWWWWWTWWFWFW
WTFFFWWWWWTFFFFFW
WFFFFWWWWWTWWWWWW
WFTFFFFFFFFFFFFPW
WWWWWWWWWWWWWWWWW