WWWWWWWWWWWWWWWWWWWW
WFFFTCTFFWWFFTTFCCWW
WWWFFFFFWWWWFWFWWWWW
WCFFTTWWWWWWFWFFTWWW
WFFFWWWFFFWWWWWFFWWW
WWWTWWWWWFWWWWFFFFWW
WWWFFFFFFFWWWWFFFWWW
WWWFWWTTTFWWWWFFWWWW
WWWFWWWWFFFFFFFFWWWW
WWWFWWFFFWWWWWWWWWPW
WWWFFFFFFFFFFFFFFFFW
WWWWWWWWWWWWWWWWWWWW