WWWWWWWWWWWWWWWWWWWWWWWWWWWW
WTTTTTTTTTTTTTTTTTTTTTTTTTTW
WTTTTTTTTTTTTFTTTTTTTTTTTTTW
WTTTTTTTTTTTTTTTTTTTTTTTTTTW
WWWWWWWWWWWWWWWWWWWWWWWWWPWW
