WWWWWWWWWWW
WFFFFFWFFFW
WFTFFFWFTFW
WFWCWFWFTFW
WFFWFFWFTFW
WFFWFFFFTFW
WWFWWWWFTPW
WFFFFFFTTFW
WFWFWFTFTFW
WCFFWFFFFFW
WWWWWWWWWWW