WWWWWWWWWWWWWWWWWWWWWWWWWWWW
WFFTTTTTTFTTTTTTTTTTTCTTTTTW
WTTTTTTTTTTTTFTTTTTTTTTTTTTW
WTTTCTTTTTTTTTTTTTTTFTTTTFFW
WTTTTTTTTFTTTTCTTTTTTTTTTFPW
WWWWWWWWWWWWWWWWWWWWWWWWWWWW